120 121 121 121 121 121 121 121 121 121 121 121 121 121 121 121 121 121 121 122
144 145 145 145 145 145 145 145 145 145 145 145 145 145 145 145 145 145 145 146
144 145 145 145 145 145 145 145 145 145 145 145 145 145 145 145 145 145 145 146
144 145 145 145 376 145 145 145 145 145 145 145 145 145 145 145 145 145 145 146
144 145 145 145 145 145 145 145 145 145 145 145 145 145 145 145 145 145 145 146
144 145 145 145 145 145 145 145 145 145 145 145 376 145 145 145 145 145 145 146
144 145 145 145 145 145 145 145 145 169 169 145 145 145 145 145 145 145 145 146
144 145 145 145 145 145 145 145 146 176 177 144 145 145 145 379 145 145 145 146
144 145 145 145 145 145 145 145 146 200 201 144 145 145 145 145 145 145 145 146
144 145 145 145 145 145 378 145 145 121 121 145 145 145 145 145 145 145 145 146
144 145 376 145 145 145 145 145 145 145 145 145 145 145 145 145 145 145 145 146
144 145 145 169 169 145 145 145 145 145 145 145 145 145 145 145 169 169 145 146
144 145 146 176 177 144 145 145 145 145 145 376 145 145 145 146 176 177 144 146
144 145 146 200 201 144 145 145 145 145 145 145 145 145 145 146 200 201 144 146
144 145 145 121 121 145 145 145 145 145 145 145 145 145 145 145 121 121 145 146
144 145 145 145 145 377 145 145 145 145 145 145 145 145 145 145 145 145 145 146
144 145 145 145 145 145 145 145 145 145 145 145 145 145 145 378 145 145 145 146
144 145 145 145 145 145 145 145 145 145 145 145 145 145 145 145 145 145 145 146
144 145 145 145 145 145 145 145 145 145 145 145 145 145 145 145 145 145 145 146
168 169 169 169 169 169 169 169 169 169 169 169 169 169 169 169 169 169 169 170