220 220 206 174 244 244 244 175 220 220 120 121 121 121 121 121 121 121 121 122
208 174 244 245 524 524 524 219 220 220 144 145 377 145 145 378 145 145 145 146
206 221 524 524 524 524 524 219 208 220 168 169 169 169 145 145 145 145 145 146
220 221 524 524 524 365 365 328 328 328 328 328 328 328 144 145 145 145 145 146
220 221 524 524 524 524 524 219 220 220 120 121 122 328 144 145 145 145 145 146
220 221 524 524 524 524 524 219 120 121 145 145 146 328 168 169 145 145 145 146
220 198 197 524 524 195 196 199 144 169 169 145 146 328 220 220 168 145 145 146
120 122 198 196 196 199 120 121 146 176 177 144 146 328 000 001 002 144 145 146
144 145 121 121 121 121 145 145 146 200 201 144 146 328 024 025 026 144 378 146
144 377 145 169 169 169 169 145 145 121 121 145 146 328 049 051 049 144 145 146
144 145 170 217 217 217 217 144 379 145 145 145 146 328 328 328 328 168 145 146
168 170 217 217 264 275 217 144 145 145 145 145 145 122 217 217 217 217 144 146
265 270 271 274 292 120 121 145 145 145 145 376 145 145 122 217 176 177 144 146
293 293 293 293 340 144 145 145 145 145 145 145 145 145 146 176 153 201 144 146
120 122 217 120 121 145 145 145 145 145 145 145 145 145 146 200 201 120 145 146
144 145 121 145 376 169 169 169 169 169 169 169 169 145 145 121 121 145 145 146
144 145 145 145 146 220 220 220 220 220 253 220 220 144 145 378 145 145 145 146
144 145 145 377 146 220 322 322 208 322 322 322 220 144 145 145 145 145 145 146
144 145 145 145 146 220 220 220 220 220 220 220 220 144 145 145 145 145 145 146
168 169 169 169 169 329 329 329 329 329 329 329 329 169 169 169 169 169 169 170