 0  1  1  1  1  1  1  1  1  1  1  1  1  1  1  1  1  1  1  2
 5  6  6  6  6  6  6  6  6  6  6  6  6  6  6  6  6  6  6  7
 5  6  6  6  6  6  6  6  6  6  6  6  6  6  6  6  6  6  6  7
 5  6  6  6 14  6  6  6  6  6  6  6  6  6  6  6  6  6  6  7
 5  6  6  6  6  6  6  6  6  6  6  6  6  6  6  6  6  6  6  7
 5  6  6  6  6  6  6  6  6  6  6  6 14  6  6  6  6  6  6  7
 5  6  6  6  6  6  6  6  6 11 11  6  6  6  6  6  6  6  6  7
 5  6  6  6  6  6  6  6  7  3  4  5  6  6  6 14  6  6  6  7
 5  6  6  6  6  6  6  6  7  8  9  5  6  6  6  6  6  6  6  7
 5  6  6  6  6  6 14  6  6  1  1  6  6  6  6  6  6  6  6  7
 5  6 14  6  6  6  6  6  6  6  6  6  6  6  6  6  6  6  6  7
 5  6  6 11 11  6  6  6  6  6  6  6  6  6  6  6 11 11  6  7
 5  6  7  3  4  5  6  6  6  6  6 14  6  6  6  7  3  4  5  7
 5  6  7  8  9  5  6  6  6  6  6  6  6  6  6  7  8  9  5  7
 5  6  6  1  1  6  6  6  6  6  6  6  6  6  6  6  1  1  6  7
 5  6  6  6  6 14  6  6  6  6  6  6  6  6  6  6  6  6  6  7
 5  6  6  6  6  6  6  6  6  6  6  6  6  6  6 14  6  6  6  7
 5  6  6  6  6  6  6  6  6  6  6  6  6  6  6  6  6  6  6  7
 5  6  6  6  6  6  6  6  6  6  6  6  6  6  6  6  6  6  6  7
10 11 11 11 11 11 11 11 11 11 11 11 11 11 11 11 11 11 11 12