 0  1  1  1  1  1  1  1  1  2
 5  6  6  6  6  6  6  6  6  7
 5  6  6 14  6  6  6  6  6  7
 5  6  6  6  6  6  6  6  6  7
 5  6  6  6  6  6  6 14  6  7
 5  6  6  6  6  6  6  6  6  7
 5  6 14  6  6  6  6  6  6  7
 5  6  6  6  6  6  6  6  6  7
 5  6  6  6  6  6  6  6  6  7
10 11 11 11 11 11 11 11 11 12
